                                                                              ####
                                                                            ########
                                                                          ############
                                                                        ################
                                                                      ####################
#################################################################################################